/mnt/e/Ian-FWI-Data/CurveVel_A/data/data1.npy	/mnt/e/Ian-FWI-Data/CurveVel_A/model/model1.npy
/mnt/e/Ian-FWI-Data/CurveVel_A/data/data2.npy	/mnt/e/Ian-FWI-Data/CurveVel_A/model/model2.npy
/mnt/e/Ian-FWI-Data/CurveVel_A/data/data3.npy	/mnt/e/Ian-FWI-Data/CurveVel_A/model/model3.npy
/mnt/e/Ian-FWI-Data/CurveVel_A/data/data4.npy	/mnt/e/Ian-FWI-Data/CurveVel_A/model/model4.npy
/mnt/e/Ian-FWI-Data/CurveVel_A/data/data5.npy	/mnt/e/Ian-FWI-Data/CurveVel_A/model/model5.npy
/mnt/e/Ian-FWI-Data/CurveVel_A/data/data6.npy	/mnt/e/Ian-FWI-Data/CurveVel_A/model/model6.npy
/mnt/e/Ian-FWI-Data/CurveVel_A/data/data7.npy	/mnt/e/Ian-FWI-Data/CurveVel_A/model/model7.npy
/mnt/e/Ian-FWI-Data/CurveVel_A/data/data8.npy	/mnt/e/Ian-FWI-Data/CurveVel_A/model/model8.npy
/mnt/e/Ian-FWI-Data/CurveVel_A/data/data9.npy	/mnt/e/Ian-FWI-Data/CurveVel_A/model/model9.npy
/mnt/e/Ian-FWI-Data/CurveVel_A/data/data10.npy	/mnt/e/Ian-FWI-Data/CurveVel_A/model/model10.npy
/mnt/e/Ian-FWI-Data/CurveVel_A/data/data11.npy	/mnt/e/Ian-FWI-Data/CurveVel_A/model/model11.npy
/mnt/e/Ian-FWI-Data/CurveVel_A/data/data12.npy	/mnt/e/Ian-FWI-Data/CurveVel_A/model/model12.npy
/mnt/e/Ian-FWI-Data/CurveVel_A/data/data13.npy	/mnt/e/Ian-FWI-Data/CurveVel_A/model/model13.npy
/mnt/e/Ian-FWI-Data/CurveVel_A/data/data14.npy	/mnt/e/Ian-FWI-Data/CurveVel_A/model/model14.npy
/mnt/e/Ian-FWI-Data/CurveVel_A/data/data15.npy	/mnt/e/Ian-FWI-Data/CurveVel_A/model/model15.npy
/mnt/e/Ian-FWI-Data/CurveVel_A/data/data16.npy	/mnt/e/Ian-FWI-Data/CurveVel_A/model/model16.npy
/mnt/e/Ian-FWI-Data/CurveVel_A/data/data17.npy	/mnt/e/Ian-FWI-Data/CurveVel_A/model/model17.npy
/mnt/e/Ian-FWI-Data/CurveVel_A/data/data18.npy	/mnt/e/Ian-FWI-Data/CurveVel_A/model/model18.npy
/mnt/e/Ian-FWI-Data/CurveVel_A/data/data19.npy	/mnt/e/Ian-FWI-Data/CurveVel_A/model/model19.npy
/mnt/e/Ian-FWI-Data/CurveVel_A/data/data20.npy	/mnt/e/Ian-FWI-Data/CurveVel_A/model/model20.npy
/mnt/e/Ian-FWI-Data/CurveVel_A/data/data21.npy	/mnt/e/Ian-FWI-Data/CurveVel_A/model/model21.npy
/mnt/e/Ian-FWI-Data/CurveVel_A/data/data22.npy	/mnt/e/Ian-FWI-Data/CurveVel_A/model/model22.npy
/mnt/e/Ian-FWI-Data/CurveVel_A/data/data23.npy	/mnt/e/Ian-FWI-Data/CurveVel_A/model/model23.npy
/mnt/e/Ian-FWI-Data/CurveVel_A/data/data24.npy	/mnt/e/Ian-FWI-Data/CurveVel_A/model/model24.npy